=========**=========
=*********C*******G=
=*=*============*=*=
=*=*=***====***=*=*=
=*=***=******=***=*=
=*================*=
=*=*******G******=*=
=*=======**=======*=
=*******==*=*******=
=*=====*=**=*=====*=
********=*==********
=*=====*=**=*=====*=
=*=G**=******=G**=*=
=*=***=*====*=***=*=
=*=******C*******=*=
=*=*S*=*====*=*S*=*=
=*=***=******=***=*=
=*=====*====*=====*=
=****************P*=
=========**=========