=*****=****=***S=**=
=P*****==*****==***=
=*=*=*==*=*==*=*==*=
**=*=****=**R*=*=*=*
**#*==*=*#*=*==*#*=*
=*****=*#***#*==*#*=
=*=*#*=*==S==*==*=*=
=*=*G*=********=*G*=
=*=*#*==*====*==*#*=
=*****=****=****=**=
=*=*#*=*==*#*==*=*==
**=*#*=*#*****#*=*=*
=*#*==*==*==*==*==*=
=*******G***#******=
=*#*==*=*#*#*=*==*#=
=*=*G****===****#*==
=*=*#*=*=====*==*=*=
=*=*#*=********=*G*=
=*#*==*==*==*==*==*=
=*******R**=****=**=