=**********=***B=**=
=P*****==*****==***=
=*=*=*==*=*==*=*==*=
**=*=****=**C*=*=*=*
****==*=***=*==***=*
=*****=*******==***=
=*=***=*==B==*==*=*=
=*=*G*=********=*G*=
=*=***==*====*==***=
=*****=****=****=**=
=*=***=*==***==*=*==
**=***=*********=*=*
=***==*==*==*==*==*=
=*******G**********=
=***==*=*****=*==**=
=*=*G****===******==
=*=***=*=====*==*=*=
=*=***=********=*G*=
=***==*==*==*==*==*=
=*******C**=****=**=