====================
=****G*==*C*==*G***=
=*=*=***=*=*=*=*=*==
=*B***********=****=
=*=***==*==*==*==*==
=******=**G**=*==*C=
=*=*=*==*==*==*==*==
=*G****=******=****=
=*=*=***=*=*=*=*=*==
=****C*==*B*==*C***=
=**===*********===*=
=****G*==***==*G***=
=**===*********===*=
=****C*==*B*==*C***=
=*=*******=*****=*==
=*G*******G********=
=*=*=*==*==*==*==*==
=******==****=*==*C=
=*=*=*==**P*==*==*==
====================